W W W W W W W W W W W W 
W T T T P T T T T T T W 
W T W W W W W W T W T W 
W T W T T T W T T W T W 
W T W T P T T T T W T W 
W T W T O O W W W W T W 
W T T T O O O O E W P W 
W T W W W W W W W W T W 
W T W O O O C O O W T W 
W T W O W W W W O W T W 
W T T T T T T T T T T W 
W W W W W W W W W W W W