W W W W W W W W W W W W
W T T T T T T T T T T W
W T P W T T T T W P T W
W T W W W O O W W W T W
W T T W E O O E W T T W
W T T O O O O O O T T W
W T T O O O O O O T T W
W T T W C O O O W T T W
W T W W W O O W W W T W
W T P W T T T T W P T W
W T T T T T T T T T T W
W W W W W W W W W W W W