W W W W W W W W W W W W W W W W W W W W W W W W W W W W 
W T T T T T T T T T W W T T T T W W T T T T T T T T T W 
W T W W W W T W W T W W T W W T W W T W W T W W W W T W 
W T W W W W T W W T W W T W W T W W T W W T W W W W T W 
W T T T T P T W W T T T T W W T T T T W W T P T T T T W 
W T W W W W T W W W W W T W W T W W W W W T W W W W T W 
W T W W W W T W W W W W T W W T W W W W W T W W W W T W 
W T W W T T T T T T T T T W W T T T T T T T T T W W T W 
W T W W T W W W W O W W W W W W W W O W W W W T W W T W 
W T W W T W W W W O W W W W W W W W O W W W W T W W T W 
O T T T T T T O O O O O O O E O O O O O O T T T T T T O 
W T W W W W T W W O W W W O O W W W O W W T W W W W T W 
W T W W W W T W W O W O E O O E O W O W W T W W W W T W 
W T T T T T T W W O W O O O E O O W O W W T T T T T T W 
W T W W W W T W W O W W W W W W W W O W W T W W W W T W 
W T W W W W T W W O O O O O C O O O O W W T W W W W T W 
W T T T W W T W W O W W W W W W W W O W W T W W T T T W 
W W W T W W T W W O W W W W W W W W O W W T W W T W W W 
O T T T W W T T T T T T T W W T T T T T T T W W T T T O 
W T T T W W T W W W W W T W W T W W W W W T W W T T T W 
W T W W W W T W W W W W T W W T W W W W W T W W W W T W 
W T W W W W T W W T T T T T T T T T T W W T W W W W T W 
W T T T T T T W W T W W T W W T W W T W W T T T T T T W 
W T W W T W W W W T W W T W W T W W T W W W W T W W T W 
W T W W T W W W W T W W T W W T W W T W W W W T W W T W 
W T W W T P T T T T W W T T T T W W T T T T P T W W T W 
W T W W W W W W W T W W W W W W W W T W W W W W W W T W 
W T W W W W W W W T W W W W W W W W T W W W W W W W T W 
W P T T T T T T T T T T T T T T T T T T T T T T T T P W 
W W W W W W W W W W W W W W W W W W W W W W W W W W W W