W O O O O O O O O O O O O O O O O O O O O O O O O O W
W O O O T T T T O O O O O O O O O O O O O O O O O O W 
W O O O W W W W O O O O O O O O O O O O O O O O O O W 
W O O O W W W W O O O O O O O O O O O O O O O O O O W 
W O O O T T T T T O O O O O O O O O O O O O O O O O W 
W O O W W W W W T O O O O O O O O O O O O O O O O O W 
W O O W W W W W T O O O O O O O O O O O O O O O O O W 
W O O W W T T T T O O O O O O O O O O O O O O O O O W 
W O O W W T W O O O O O O O O O O O O O O O O O O O W 
W O O W W T W O O O O O O O O O O O O O O O O O O O W 
W T T T T T T O O O O O O O O O O O O O O O O O O O W 
W T W W W W O O O O O O O O O O O O O O O O O O O O W 
W T W W W W O O O O O O O O O O O O O O O O O O O O W 
W T T T T T T O O O O O O O O O O O O O O O O O O O W 
W O O O O O T W W O O O O O O O O O O O O O O O O O W 
W O O O O O T W W O O O O O O O O O O O O O O O O O W 
W O O O O O T W W O O O O O O O O O O O O O O O O O W 
W O O O O O T W W O O O O O O O O O O O O O O O O O W 
W O O O O O T T T T O O O O O O O O O O O O O O O O W 
W O O O O O O O W W W W W O O O O O O O O O O O O O W 
W O O O O O O W W W W W W O O O O O O O O O O O O O W 
W O O O O O O W W T O O O O O O O O O O O O O O O O W 
W O O O O O T W W T O O O O O O O O O O O O O O O O W 
W O O O O W W O O T O O O O O O O O O O O O O O O O W 
W O O O O W W O O T O O O O O O O O O O O O O O O O W 
W O W W T O O O O T O O O O O O O O O O O O O O O O W 
W O W W W O O O O O O O O O O O O O O O O O O O O O W 
W O W W W O O O O O O O O O O O O O O O O O O O O O W 
W T O O O O O O O O O O O O O O O O O O O O O O O O W 
W W W W W W W W W W W W W W W W W W W W W W W W W W W